Jan Ellenberg	CBB
Alba Diz-Munoz	CBB
Darren Gilmour	CBB
Christian Haering	CBB
Lars Hufnagel	CBB
Martin Jechlinger	CBB
Peter Lenart	CBB
Francois Nedelec	CBB
Pierre Neveu	CBB
Rainer Pepperkok	CBB
Robert Prevedel	CBB
Jonas Ries	CBB
Carsten Schultz	CBB
Yannick Schwab	CBB
Anne Ephrussi	DB
Detlev Arendt	DB
Alexander Aulehla	DB
Stefano De_Renzis	DB
Marcus Heisler	DB
Takashi Hiiragi	DB
Francesca Peri	DB
Eileen Furlong	GB
Wolfgang Huber	GB
Jan Korbel	GB
Christoph Merten	GB
Kyung-Min Noh	GB
Mikhail Savitski	GB
Lars Steinmetz	GB
Nassos Typas	GB
Peer Bork	SCB
Christoph Mueller_christoph	SCB
Theodore Alexandrov	SCB
Orsolya Barabas	SCB
Martin Beck	SCB
John Briggs	SCB
Anne-Claude Gavin	SCB
Toby Gibson	SCB
Janosch Hennig	SCB
Edward Lemke	SCB
Kiran Patil	SCB
Carsten Sachse	SCB
Judith Zaugg	SCB
Georg Zeller	SCB
